30
15
0 17 17 17 17 17 17 17 17 17 17 17 17 17 2 0 17 17 17 17 17 17 17 17 17 17 17 17 17 2
16 31 31 31 31 31 16 31 31 31 31 31 31 31 18 31 31 31 31 31 31 16 31 31 31 31 31 31 31 18
16 31 31 31 31 31 16 31 31 31 31 31 31 31 18 31 31 31 31 31 31 16 31 31 31 31 31 31 31 18
16 31 31 31 31 31 16 31 31 31 31 31 31 31 18 31 31 31 31 31 31 16 31 31 31 31 31 31 31 18
16 31 31 31 31 31 16 31 31 31 31 31 31 31 18 31 31 31 31 31 31 16 31 31 31 31 31 31 31 18
16 31 31 31 31 31 16 31 31 31 31 31 31 31 18 31 31 31 31 31 31 16 31 31 31 31 31 31 31 18
16 49 49 31 49 49 50 31 31 31 31 31 31 31 18 31 49 49 31 49 49 50 31 31 31 31 31 31 31 18
16 31 31 31 31 31 16 31 31 31 31 31 31 31 18 31 31 31 31 31 31 16 31 31 31 31 31 31 31 18
16 31 31 31 31 31 16 31 31 31 31 31 31 31 18 31 31 31 31 31 31 16 31 31 31 31 31 31 31 18
16 31 31 31 31 31 48 49 49 49 49 31 49 49 18 31 31 31 31 31 31 48 49 49 49 49 31 49 49 18
30 31 31 31 31 31 31 31 31 31 31 31 31 31 18 31 31 31 31 31 31 31 31 31 31 31 31 31 31 18
16 31 31 31 31 31 16 31 31 31 31 31 31 31 31 31 16 31 31 31 31 31 16 31 31 31 31 31 31 18
16 31 31 31 31 31 16 31 31 31 31 31 31 31 18 31 31 31 31 31 31 16 31 31 31 31 31 31 31 18
16 31 31 31 31 31 16 31 31 31 31 31 31 31 18 31 31 31 31 31 31 16 31 31 31 31 31 31 31 18
48 49 49 49 49 49 49 49 49 49 49 49 49 49 50 48 49 49 49 49 49 49 49 49 49 49 49 49 49 50
